erro Natura	Correção
-------------------------------------------
#caixa-dos-pirolitos	caixa dos pirolitos
#cor-de-laranja	cor de laranja                 [ALB] Corrigido
#assumpção	assunção                       [ALB] OK
#abreação	ab-reação                      [ALB] Corrigido
#alcalinoterroso	alcalino-terroso       [ALB] Great
#anjo-da-guarda	anjo da guarda                 [ALB] Corrigido
#autocorrecção	autocorreção                   [ALB] Corrigido
#autocorrectivo	autocorretivo                  [ALB] Corrigido
#auto-de-fé	auto de fé                     [ALB] Corrigido
#bicha-de-sete-cabeças	bicha de sete cabeças  [ALB] Corrigido
#Bicho-de-sete-cabeças	bicho de sete cabeças  [ALB] não existe com maiúscula no nosso dic
#bicho-do-buraco	bicho do buraco        [ALB] Corrigido
#bicho-do-mato	bicho do mato                  [ALB] Corrigido
#bico-de-obra	bico de obra                   [ALB] Corrigido
#bilhete-de-visita	bilhete de visita      [ALB] REMOVIDO (nao acho que faça sentido)
--bissectar	bissetar – bissectar (PB) --> a priberam diz que é bissectar :S
#boca-de-fogo	boca de fogo                   [ALB] Corrigido
#boca-de-incêndio	boca de incêndio       [ALB] Corrigido
#boca-de-sino	boca de sino                   [ALB] Corrigido
#bota-de-elástico	bota de elástico       [ALB] Corrigido
#cabeça-de-alho-chocho	cabeça de alho chocho  [ALB] Corrigido
#cabeça-de-série	cabeça de série        [ALB] Corrigido
#cabeça-de-vento	cabeça de vento        [ALB] Corrigido
#cabeça-no-ar	cabeça no ar                   [ALB] Corrigido
#caixa-de-ar	caixa de ar                    [ALB] Corrigido
#caixa-de-óculos	caixa de óculos        [ALB] Corrigido
#câmara-de-ar	câmaras de ar                  [ALB] Corrigido
#caminho-de-ferro	caminho de ferro       [ALB] Corrigido
#camisa-de-forças	camisa de forças       [ALB] Corrigido
#canto-de-cisne	canto de cisne                 [ALB] Corrigido
#caraterologia	caraterologia (PB) caracterologia (PE)    [ALB] Great
#carreira-de-tiro	carreira de tiro       [ALB] Corrigido
#cartão-de-visita	cartão de visita       [ALB] Corrigido
#casca-de-noz	casca de noz                   [ALB] Corrigido
#cavalo-de-batalha	cavalo de batalha      [ALB] Corrigido
#céu-da-boca	céu da boca                    [ALB] Corrigido
#chapéu-de-chuva	chapéu de chuva        [ALB] Corrigido
#chapéu-de-sol	chapéu de sol                  [ALB] Corrigido
#colete-de-forças	colete de forças       [ALB] Corrigido
#conto-do-vigário	conto do vigário       [ALB] Corrigido
#testa-de-ferro	testa de ferro                 [ALB] Corrigido
#toucinho-do-céu	toucinho do céu        [ALB] Corrigido
#turbo-reator	turborreator                   [ALB] Corrigido
#unhas-de-fome	unhas de fome                  [ALB] Corrigido
#vilacondense	vila-condense                  [ALB] whatever
#vilafranquense	vila-franquense                [ALB] whatever
#vilanovense	vila-novense                   [ALB] whatever
#ar-condicionado	ar condicionado        [ALB] Corrigido
#não-te-rales	não te rales                   [ALB] Corrigido
#landegrave	apenas atestadas landgrave e landegrávio   [ALB] Fixed - até tirava e pronto...
#energitismo	energetismo                    [ALB] Corrigido
#fora-da-lei	fora da lei                    [ALB] Corrigido
#frente-a-frente	frente a frente
#géiser	geiser ou guéiser                    [ALB] Whatever
# felcro	velcro ? feltro ?        [ALB] Removido
# ferente	                         [ALB] Removido
# abstusa	abstrusa                 [ALB] corrigido
#amiudamente	amiudadamente ou miudamente.   [ALB] removido
#comunial	comunal?                 [ALB] Removido
#germinibilidade	germinabilidade    [ALB] corrigido
#há-de	há de
#hão-de	hão de
#lúgrebe	lúgubre            [ALB] removido o primeiro
#macanicismo	mecanicismo              [ALB] Removido
#maleficientíssimo	maleficentíssimo?  [ALB] removido e pronto
#percursionista	percussionista           [ALB] Corrigido
#pusilâmine	pusilânime               [ALB] corrigido
#quarto-de-hora	quarto de hora           [ALB] Corrigido
#telequinesia	telecinesia              [ALB] Corrigido
#tempestoso	tempestuoso              [ALB] removido o 1o
#abulíco	abúlico                  [ALB] Corrigido
--além-fronteira	apenas atestado além-fronteiras
#alucinogéno	alucinogénio             [ALB] corrigido
#antimonóxido	antimonióxido (antimónio+óxido)    [ALB] corrigido
#aracnoídeo	aracnóideo               [ALB] removido o errado
#arborícula	grafia correta arborícola    [ALB] corrigido
#aterraplanar	apenas temos atestado aterraplenar [ALB] corrigido
#boite	boîte                             [ALB] Removido já há tempos
#cavernícula	cavernícola            [ALB] Corrigido
#cineastra	cineasta                [ALB] removido o 1o
#coderniz	codorniz         [FIXED]
#conetar	conectar (PE)            Great
#conglumerativo	conglomerativo
#coreáceo	coriáceo
#correlegionário	correligionário
#dendolatria	dendrolatria
#descompustura	descompostura
#disfrutar	desfrutar          [ALB] removido o 1o
#endócrinologista	endocrinologista  [ALB] corrigido
#gadanheirro	gadanheiro                [ALB] fixed.. ops
#haraquiri	haraquíri
#hebraista	hebraísta
#imprescritabilidade	imprescritibilidade
#mega-hertz	megahertz
#micrólite	microlite
#oitavos-de-final	oitavos de final
#quilo-hertz	quilohertz
#silíqua	síliqua
#termistor	termístor                    [ALB] corrigido
#torrão-de-açucar	torrão-de-açúcar   [ALB] Adicionado o acento
#dia-a-dia	dia a dia                  [ALB] Corrigido
#extra-uterino	extrauterino               [ALB] oops, fixed
#farinha-de-pau	farinha de pau             [ALB] Corrigido
#fim-de-semana	fim de semana              [ALB] corrigido
#fio-de-prumo	fio de prumo               [ALB] Corrigido
#fogo-de-artifício	fogo de artifício  [ALB] Corrigido
#fora-de-jogo	fora de jogo               [ALB] Corrigido
#gaita-de-foles	gaita de foles             [ALB] Corrigido
#interrelacionar	inter-relacionar      [ALB] acho que melhorou
#língua-de-gato	língua de gato                [fixed]
#lua-de-mel	lua de mel                 [ALB] corrigido
#maçã-de-adão	maçã de Adão             [ALB] fixed
#mão-de-obra	mão de obra               [ALB] corrigido
#mesa-de-cabeceira	mesa de cabeceira      [ALB] corrigido
#mestre-de-cerimónias	mestre de cerimónias    [ALB] corrigido
#mestre-de-obras	mestre de obras     [ALB] corrigido
#mini-saia	minissaia                [ALB] Corrigido
#mulher-a-dias	mulher a dias            [ALB] Corrigido
#onomatopéico	onomatopeico             [ALB] great
#pão-de-ló	pão de ló                 [ALB] Corrigido
#pau-de-cabeleira	pau de cabeleira [ALB] Corrigido
#paz-de-alma	paz de alma              [ALB] Corrigido
#pé-de-cabra	pé de cabra             [ALB] Corrigido
#pé-de-vento	pé de vento            [ALB] Corrigido
#pó-de-arroz	pó de arroz            [ALB] Corrigido
#ponta-de-lança	ponta de lança              [ALB] Corrigido
#quarto-de-final	quarto de final     [ALB] corrigido 
#quartos-de-final	quartos de final    [ALB] corrigido
#rés-do-chão	rés do chão                 [ALB] corrigido
#rosa-dos-ventos	rosa dos ventos     [ALB] corrigido
#fins-de-semana	fins de semana, plural de fim de semana [ALB] corrigido
#terferência	não atestado                   [ALB] removido e pronto
#calenda	plurale tantum – apenas calendas - corrigido para "calendas/#nfp"
#autos-de-fé	autos de fé                  [ALB] fixed
#co-orientador	coorientador        [ALB] fixed
